
             XXXXXXXXX
      XXXXXXXX       XXXXXXXXXX
      X	                            XX   X XXXX XXX
      X     XXXXX                   X X  X X  X X
      X    XX   XXX           X     X  X X XXXX XXX
      X     X          XX     X     X   XX X  X   X
      XX    XXXXXaaaaaaXXXXXXXX     X    X X  X XXX
    XXX     X   X             X
    X      XX   XXX           X
    X       X            1    X
    X 3	    X        XXXXXXXXXXXXXXXXXXXXXX    
 XXXXXXXXXXXXXXX              X     C     X
 X   B      X              @  X     C     X
 X   XXX  XXX    XXXXXXXXXXXXXX    XX     X
 X  XX 	    X                 X     X     X
 X   X   XXXX              0  XX    X     X
 XX	 X $ X  XXXXXXbbbbbbbbXXXXX     X   XXXXXX
 X   XXXXX  A                 X   XXX        X
 X          A                 X     X      2 X
 XXXXXXXXXXXXXXXXXXXXX     XXXXX    XXXXXXXXXX
            X                       X
            X     XXXXXXXXXXXXXXXXXXX
            X        D        X
            XXXXXXXXXX  4  5  X
                    XXXXXXXXXXX